

[[101,91,91,91,91,91,91,91,91,91,91,91,91,91,91,91,91,91,91,91,91,91,91,91,91,103], 
[81,69,69,69,70, 0, 0, 0, 0, 0, 0, 0, 0, 0, 0, 0, 0, 0, 0, 0], 
[81,80,80,80,81, 0, 0, 0, 0, 0, 0, 0, 0, 0, 0, 0, 0, 0, 0, 0], 
[81,91,91,91,92, 0, 0, 0, 0, 0, 0, 0, 0, 0,71, 0, 0, 0, 0, 0], 
[81, 0, 0, 0, 0, 0, 0, 0, 0, 0, 0, 0, 0, 0, 0, 0, 0, 0, 0, 0],
[81, 0, 0, 0, 0, 0, 0, 0, 0, 0, 0, 0, 0, 0, 0, 0, 0, 0, 0, 0],
[81, 0, 0, 0, 0, 0, 0, 0, 0,71, 0, 0, 0, 0, 0, 0, 0, 0, 0, 0],
[81, 0, 0, 0, 0, 0, 0, 0, 0, 0, 0, 0, 0, 0, 0, 0, 0, 0, 0, 0],
[81, 0, 0, 0, 0, 0, 0, 0, 0, 0, 0, 0, 0, 0, 0, 0, 0, 0, 0, 0],
[81, 0, 0, 0, 0, 0, 0, 0, 0, 0, 0, 0, 0, 0,71, 0, 0, 0, 0, 0],
[81, 0, 0, 0, 0, 0, 0, 0, 0, 0, 0, 0, 0, 0, 0, 0, 0, 0, 0, 0],
[112,69,69,69,69,69,69,69,69,69,69,69,69,69,69,69,69,69,69,69]]